XLH = "countries/XLH.txt"
XOO = "countries/XOO.txt"
XAD = "countries/XAD.txt"
XSS = "countries/Switzerland.txt"
XRM = "countries/Romansh.txt"
XAR = "countries/XAR.txt"
XAQ = "countries/XAQ.txt"
XIE = "countries/XIE.txt"
XNI = "countries/XNI.txt"
XNE = "countries/XNE.txt"
XNF = "countries/France.txt"
XNM = "countries/XNM.txt"
XCT = "countries/XCT.txt"
XTY = "countries/XTY.txt"
XRP = "countries/XRP.txt"
XGE = "countries/Neo-DDR.txt"
XMD = "countries/XMD.txt"
XPR = "countries/XPR.txt"
XLV = "countries/XLV.txt"
XAP = "countries/XAP.txt"
XPY = "countries/XPY.txt"
XTI = "countries/XTI.txt"
XDK = "countries/XDK.txt"
XWA = "countries/XWA.txt"
XW2 = "countries/XW2.txt"
XPW = "countries/XPW.txt"
XTR = "countries/XTR.txt"
XJY = "countries/XJY.txt"
XAG = "countries/XAG.txt"
XCA = "countries/XCA.txt"
XNR = "countries/XNR.txt"
XSH = "countries/XSH.txt"
XSA = "countries/XSA.txt"
XLX = "countries/XLX.txt"
XIA = "countries/ItalianRepublic.txt"
XRA = "countries/XRA.txt"
XFR = "countries/XFR.txt"
XAL = "countries/XAL.txt"
XFW = "countries/Liberia.txt"
XPE = "countries/XPE.txt"
XLF = "countries/XLF.txt"
XBR = "countries/XBR.txt"
XBC = "countries/XBC.txt"
XHP = "countries/XHP.txt"
XLA = "countries/XLA.txt"
XIT = "countries/XIT.txt"
XGL = "countries/XGL.txt"
XCM = "countries/XCM.txt"
XKR = "countries/XKR.txt"
XGF = "countries/XGF.txt"